type octile
height 13
width 13
map
.....T.......
T..T.....TT..
.............
.......T.TT..
.....T.......
...T.T.T...T.
...........T.
...T.T.T.TTT.
.....T.......
.T.TTTTT.T.T.
.T.....T.....
TT.T.........
.....T.......
