type octile
height 19
width 19
map
..............T....
.TTTTTTTTTTTT.T....
....T.........T....
....TTTT..TTTTTT..T
....T..T..T........
..TTT..T....TTTTT..
.......T....T......
TTTTTTTTTTTTT..TTT.
...............T.T.
.TT.TTTTTTTTTTTT.T.
.T..T..........T...
.T..T....T.....T...
.T..TTTTTT..TTTT.TT
.TTTT..............
......TTTTTTTTT....
.TTTTTT.......TTTT.
.....T...T....T....
.....TT..T....T....
.........T....T....