type octile
height 51
width 26
map
TTTTTTTTTTTTTTTTTTTTTTTTTT
....TTTTTTTT.TTTT.......TT
.....T........TTT........T
..TT.....T.....TTTTTT....T
..TTT...TTT.....TTTTTT...T
...T......TTTT..TTT.TTT..T
....T........TT.......T..T
..TTTTTT..........T..TT..T
..TT...TT............TTT.T
..TT...TTT...T...T..T..T.T
..TT...TTT..TT...TT.T....T
.TTTTT.TTT..TTT.TTTT.T...T
..TTTT..TT...TT......T.T.T
....TT.TTT...........T...T
...TTT.T.TT.....TTT...T..T
...TTT...TT..T........T..T
..TTT........TT....TT...TT
..TTT...T.....TT...TTT.TTT
.TTT....TT.....T...TT..TTT
.TT...TTTTTTT.TT.......TTT
..T.....TT....TT.......TTT
........T....TTT...TTT.TTT
.....TTTT...TTT....TT...TT
.....TTT...TTT...........T
..........................
..........................
.........................T
.....................T...T
.....T.............TT....T
....TTTT......TT..TT.T...T
.....TTTTT............T..T
......TTTT............TTTT
..T.....TTTT...........TTT
....T...TTTTTTT...TTTTTTTT
..TTTT...TTTTTTTTTTTTTTTTT
....TT............TTTTTTTT
....TT.............TTTTTTT
....TT..............TTTTTT
....T...............TTTTTT
..TTT................TTTTT
..TT..........T.....TTTTTT
.TT.............TTTTTTTTTT
.....T......TTTTTTTTTTTTTT
........TTTTTTTT.......T.T
......TTTTTTTT.....TT....T
..TTTTTTTT.......TTTT....T
..TTTTTT........TTT......T
...............TTTT......T
.............TTTTTT......T
........TTTTTTTTTTTTTTTTTT
TTTTTTTTTTTTTTTTTTTTTTTTTT
