type octile
height 51
width 52
map
TTTTTTTTTTTTTTTTTTTTTTTTTTTTTTTTTTTTTTTTTTTTTTTTTTTT
T...TTT...........T...TT......TTTTTTTT.TTTT.......TT
T...TTT.........T...TTTT.......T........TTT........T
T................T..TTTT....TT.....T.....TTTTTT....T
T..T......T..T....T..TTTT...TTT...TTT.....TTTTTT...T
T..........T...T.....TTTT....T......TTTT..TTT.TTT..T
TT..........TTT.....T.TTT.....T........TT.......T..T
TT.......T.TTTTT......TTT...TTTTTT..........T..TT..T
TT.........TTTTT.T....TTT...TT...TT............TTT.T
TT.......T.TTTTT....T.TTT...TT...TTT...T...T..T..T.T
TT..T......TTTTT......TTTT..TT...TTT..TT...TT.T....T
TT......T...TTT...T..T.TTT.TTTTT.TTT..TTT.TTTT.T...T
TTT........T...T.......TT...TTTT..TT...TT......T.T.T
TTTTTTTT.........T..T..TT.....TT.TTT...........T...T
TT.T...T..............TTT....TTT.T.TT.....TTT...T..T
TT.T.T.T.............TTTTT...TTT...TT..T........T..T
TT.T.T.T.............TTTT...TTT........TT....TT...TT
TT.T.T.T.............TTTT...TTT...T.....TT...TTT.TTT
TT...T.T.........T...TTTTT.TTT....TT.....T...TT..TTT
TTTTTT.T.......TTTT...TTTT.TT...TTTTTTT.TT.......TTT
TTT..........TTTTTTT..TTT...T.....TT....TT.......TTT
TT.........TTTTTTTTT..............T....TTT...TTT.TTT
TT........TTTTTTTTT............TTTT...TTT....TT...TT
T........TTTTTTTTTTT...........TTT...TTT...........T
T.......TTTTTTTTTT....T.............................
T........TTTTTTT......T.............................
T........TTTTTT.......T............................T
T.......TTTTTTT.....TTTT.......................T...T
T.........TTTT......TTTTT......T.............TT....T
TT.........TT........TTT......TTTT......TT..TT.T...T
TT....................T........TTTTT............T..T
TTT..T..........TT..............TTTT............TTTT
TTT.TTT........TTTT.........T.....TTTT...........TTT
TT..TTT.........TTTT...TT.....T...TTTTTTT...TTTTTTTT
T..TTTT..........TTTT.TTT...TTTT...TTTTTTTTTTTTTTTTT
T..TT.....TTTT....TTTTTT......TT............TTTTTTTT
T.TTT....TTTTTT...TTTTTT......TT.............TTTTTTT
T.TTT...TTTTTTTTT..TTTT.......TT..............TTTTTT
T.TTT..TTTTTTTTTTTTTTT........T...............TTTTTT
T.TTTT.TTTTTTTTTTTTT...TT...TTT................TTTTT
T.TTTT..TTTTTTTTTTT...TT....TT..........T.....TTTTTT
T.TTTT..TTTTTTTTT....TTT...TT.............TTTTTTTTTT
T.TTTT...TTTTTTTTT..TTTT.......T......TTTTTTTTTTTTTT
T..TTTT...TTTTTTTT....TT..........TTTTTTTT.......T.T
T..TTTT....TTTTTTTT....TT.......TTTTTTTT.....TT....T
T..TTTTT..TTTTT....TTTTT....TTTTTTTT.......TTTT....T
TT.TTTTTTTTTT...TT..TTTT....TTTTTT........TTT......T
TT.TTTTTTTTTT..TTT.......................TTTT......T
TT...TTTTTTTTT.TTTT.TTT................TTTTTT......T
TTT...TTTTTTTTTTTTTTTTTTT.........TTTTTTTTTTTTTTTTTT
TTTTTTTTTTTTTTTTTTTTTTTTTTTTTTTTTTTTTTTTTTTTTTTTTTTT
