type octile
height 51
width 26
map
TTTTTTTTTTTTTTTTTTTTTTTTTT
T...TTT...........T...TT..
T...TTT.........T...TTTT..
T................T..TTTT..
T..T......T..T....T..TTTT.
T..........T...T.....TTTT.
TT..........TTT.....T.TTT.
TT.......T.TTTTT......TTT.
TT.........TTTTT.T....TTT.
TT.......T.TTTTT....T.TTT.
TT..T......TTTTT......TTTT
TT......T...TTT...T..T.TTT
TTT........T...T.......TT.
TTTTTTTT.........T..T..TT.
TT.T...T..............TTT.
TT.T.T.T.............TTTTT
TT.T.T.T.............TTTT.
TT.T.T.T.............TTTT.
TT...T.T.........T...TTTTT
TTTTTT.T.......TTTT...TTTT
TTT..........TTTTTTT..TTT.
TT.........TTTTTTTTT......
TT........TTTTTTTTT.......
T........TTTTTTTTTTT......
T.......TTTTTTTTTT....T...
T........TTTTTTT......T...
T........TTTTTT.......T...
T.......TTTTTTT.....TTTT..
T.........TTTT......TTTTT.
TT.........TT........TTT..
TT....................T...
TTT..T..........TT........
TTT.TTT........TTTT.......
TT..TTT.........TTTT...TT.
T..TTTT..........TTTT.TTT.
T..TT.....TTTT....TTTTTT..
T.TTT....TTTTTT...TTTTTT..
T.TTT...TTTTTTTTT..TTTT...
T.TTT..TTTTTTTTTTTTTTT....
T.TTTT.TTTTTTTTTTTTT...TT.
T.TTTT..TTTTTTTTTTT...TT..
T.TTTT..TTTTTTTTT....TTT..
T.TTTT...TTTTTTTTT..TTTT..
T..TTTT...TTTTTTTT....TT..
T..TTTT....TTTTTTTT....TT.
T..TTTTT..TTTTT....TTTTT..
TT.TTTTTTTTTT...TT..TTTT..
TT.TTTTTTTTTT..TTT........
TT...TTTTTTTTT.TTTT.TTT...
TTT...TTTTTTTTTTTTTTTTTTT.
TTTTTTTTTTTTTTTTTTTTTTTTTT
