type octile
height 102
width 104
map
TTTTTTTTTTTTTTTTTTTTTTTTTTTTTTTTTTTTTTTTTTTTTTTTTTTTTTTTTTTTTTTTTTTTTTTTTTTTTTTTTTTTTTTTTTTTTTTTTTTTTTTT
TTTTTTTTTTTTTTTTTTTTTTTTTTTTTTTTTTTTTTTTTTTTTTTTTTTTTTTTTTTTTTTTTTTTTTTTTTTTTTTTTTTTTTTTTTTTTTTTTTTTTTTT
TT......TTTTTT......................TT......TTTT............TTTTTTTTTTTTTTTT..TTTTTTTT..............TTTT
TT......TTTTTT......................TT......TTTT............TTTTTTTTTTTTTTTT..TTTTTTTT..............TTTT
TT......TTTTTT..................TT......TTTTTTTT..............TT................TTTTTT................TT
TT......TTTTTT..................TT......TTTTTTTT..............TT................TTTTTT................TT
TT................................TT....TTTTTTTT........TTTT..........TT..........TTTTTTTTTTTT........TT
TT................................TT....TTTTTTTT........TTTT..........TT..........TTTTTTTTTTTT........TT
TT....TT............TT....TT........TT....TTTTTTTT......TTTTTT......TTTTTT..........TTTTTTTTTTTT......TT
TT....TT............TT....TT........TT....TTTTTTTT......TTTTTT......TTTTTT..........TTTTTTTTTTTT......TT
TT....................TT......TT..........TTTTTTTT........TT............TTTTTTTT....TTTTTT..TTTTTT....TT
TT....................TT......TT..........TTTTTTTT........TT............TTTTTTTT....TTTTTT..TTTTTT....TT
TTTT....................TTTTTT..........TT..TTTTTT..........TT................TTTT..............TT....TT
TTTT....................TTTTTT..........TT..TTTTTT..........TT................TTTT..............TT....TT
TTTT..............TT..TTTTTTTTTT............TTTTTT......TTTTTTTTTTTT....................TT....TTTT....TT
TTTT..............TT..TTTTTTTTTT............TTTTTT......TTTTTTTTTTTT....................TT....TTTT....TT
TTTT..................TTTTTTTTTT..TT........TTTTTT......TTTT......TTTT........................TTTTTT..TT
TTTT..................TTTTTTTTTT..TT........TTTTTT......TTTT......TTTT........................TTTTTT..TT
TTTT..............TT..TTTTTTTTTT........TT..TTTTTT......TTTT......TTTTTT......TT......TT....TT....TT..TT
TTTT..............TT..TTTTTTTTTT........TT..TTTTTT......TTTT......TTTTTT......TT......TT....TT....TT..TT
TTTT....TT............TTTTTTTTTT............TTTTTTTT....TTTT......TTTTTT....TTTT......TTTT..TT........TT
TTTT....TT............TTTTTTTTTT............TTTTTTTT....TTTT......TTTTTT....TTTT......TTTT..TT........TT
TTTT............TT......TTTTTT......TT....TT..TTTTTT..TTTTTTTTTT..TTTTTT....TTTTTT..TTTTTTTT..TT......TT
TTTT............TT......TTTTTT......TT....TT..TTTTTT..TTTTTTTTTT..TTTTTT....TTTTTT..TTTTTTTT..TT......TT
TTTTTT................TT......TT..............TTTT......TTTTTTTT....TTTT......TTTT............TT..TT..TT
TTTTTT................TT......TT..............TTTT......TTTTTTTT....TTTT......TTTT............TT..TT..TT
TTTTTTTTTTTTTTTT..................TT....TT....TTTT..........TTTT..TTTTTT......................TT......TT
TTTTTTTTTTTTTTTT..................TT....TT....TTTT..........TTTT..TTTTTT......................TT......TT
TTTT..TT......TT............................TTTTTT........TTTTTT..TT..TTTT..........TTTTTT......TT....TT
TTTT..TT......TT............................TTTTTT........TTTTTT..TT..TTTT..........TTTTTT......TT....TT
TTTT..TT..TT..TT..........................TTTTTTTTTT......TTTTTT......TTTT....TT................TT....TT
TTTT..TT..TT..TT..........................TTTTTTTTTT......TTTTTT......TTTT....TT................TT....TT
TTTT..TT..TT..TT..........................TTTTTTTT......TTTTTT................TTTT........TTTT......TTTT
TTTT..TT..TT..TT..........................TTTTTTTT......TTTTTT................TTTT........TTTT......TTTT
TTTT..TT..TT..TT..........................TTTTTTTT......TTTTTT......TT..........TTTT......TTTTTT..TTTTTT
TTTT..TT..TT..TT..........................TTTTTTTT......TTTTTT......TT..........TTTT......TTTTTT..TTTTTT
TTTT......TT..TT..................TT......TTTTTTTTTT..TTTTTT........TTTT..........TT......TTTT....TTTTTT
TTTT......TT..TT..................TT......TTTTTTTTTT..TTTTTT........TTTT..........TT......TTTT....TTTTTT
TTTTTTTTTTTT..TT..............TTTTTTTT......TTTTTTTT..TTTT......TTTTTTTTTTTTTT..TTTT..............TTTTTT
TTTTTTTTTTTT..TT..............TTTTTTTT......TTTTTTTT..TTTT......TTTTTTTTTTTTTT..TTTT..............TTTTTT
TTTTTT....................TTTTTTTTTTTTTT....TTTTTT......TT..........TTTT........TTTT..............TTTTTT
TTTTTT....................TTTTTTTTTTTTTT....TTTTTT......TT..........TTTT........TTTT..............TTTTTT
TTTT..................TTTTTTTTTTTTTTTTTT............................TT........TTTTTT......TTTTTT..TTTTTT
TTTT..................TTTTTTTTTTTTTTTTTT............................TT........TTTTTT......TTTTTT..TTTTTT
TTTT................TTTTTTTTTTTTTTTTTT........................TTTTTTTT......TTTTTT........TTTT......TTTT
TTTT................TTTTTTTTTTTTTTTTTT........................TTTTTTTT......TTTTTT........TTTT......TTTT
TT................TTTTTTTTTTTTTTTTTTTTTT......................TTTTTT......TTTTTT......................TT
TT................TTTTTTTTTTTTTTTTTTTTTT......................TTTTTT......TTTTTT......................TT
TT..............TTTTTTTTTTTTTTTTTTTT........TT..........................................................
TT..............TTTTTTTTTTTTTTTTTTTT........TT..........................................................
TT................TTTTTTTTTTTTTT............TT..........................................................
TT................TTTTTTTTTTTTTT............TT..........................................................
TT................TTTTTTTTTTTT..............TT........................................................TT
TT................TTTTTTTTTTTT..............TT........................................................TT
TT..............TTTTTTTTTTTTTT..........TTTTTTTT..............................................TT......TT
TT..............TTTTTTTTTTTTTT..........TTTTTTTT..............................................TT......TT
TT..................TTTTTTTT............TTTTTTTTTT............TT..........................TTTT........TT
TT..................TTTTTTTT............TTTTTTTTTT............TT..........................TTTT........TT
TTTT..................TTTT................TTTTTT............TTTTTTTT............TTTT....TTTT..TT......TT
TTTT..................TTTT................TTTTTT............TTTTTTTT............TTTT....TTTT..TT......TT
TTTT........................................TT................TTTTTTTTTT........................TT....TT
TTTT........................................TT................TTTTTTTTTT........................TT....TT
TTTTTT....TT....................TTTT............................TTTTTTTT........................TTTTTTTT
TTTTTT....TT....................TTTT............................TTTTTTTT........................TTTTTTTT
TTTTTT..TTTTTT................TTTTTTTT..................TT..........TTTTTTTT......................TTTTTT
TTTTTT..TTTTTT................TTTTTTTT..................TT..........TTTTTTTT......................TTTTTT
TTTT....TTTTTT..................TTTTTTTT......TTTT..........TT......TTTTTTTTTTTTTT......TTTTTTTTTTTTTTTT
TTTT....TTTTTT..................TTTTTTTT......TTTT..........TT......TTTTTTTTTTTTTT......TTTTTTTTTTTTTTTT
TT....TTTTTTTT....................TTTTTTTT..TTTTTT......TTTTTTTT......TTTTTTTTTTTTTTTTTTTTTTTTTTTTTTTTTT
TT....TTTTTTTT....................TTTTTTTT..TTTTTT......TTTTTTTT......TTTTTTTTTTTTTTTTTTTTTTTTTTTTTTTTTT
TT....TTTT..........TTTTTTTT........TTTTTTTTTTTT............TTTT........................TTTTTTTTTTTTTTTT
TT....TTTT..........TTTTTTTT........TTTTTTTTTTTT............TTTT........................TTTTTTTTTTTTTTTT
TT..TTTTTT........TTTTTTTTTTTT......TTTTTTTTTTTT............TTTT..........................TTTTTTTTTTTTTT
TT..TTTTTT........TTTTTTTTTTTT......TTTTTTTTTTTT............TTTT..........................TTTTTTTTTTTTTT
TT..TTTTTT......TTTTTTTTTTTTTTTTTT....TTTTTTTT..............TTTT............................TTTTTTTTTTTT
TT..TTTTTT......TTTTTTTTTTTTTTTTTT....TTTTTTTT..............TTTT............................TTTTTTTTTTTT
TT..TTTTTT....TTTTTTTTTTTTTTTTTTTTTTTTTTTTTT................TT..............................TTTTTTTTTTTT
TT..TTTTTT....TTTTTTTTTTTTTTTTTTTTTTTTTTTTTT................TT..............................TTTTTTTTTTTT
TT..TTTTTTTT..TTTTTTTTTTTTTTTTTTTTTTTTTT......TTTT......TTTTTT................................TTTTTTTTTT
TT..TTTTTTTT..TTTTTTTTTTTTTTTTTTTTTTTTTT......TTTT......TTTTTT................................TTTTTTTTTT
TT..TTTTTTTT....TTTTTTTTTTTTTTTTTTTTTT......TTTT........TTTT....................TT..........TTTTTTTTTTTT
TT..TTTTTTTT....TTTTTTTTTTTTTTTTTTTTTT......TTTT........TTTT....................TT..........TTTTTTTTTTTT
TT..TTTTTTTT....TTTTTTTTTTTTTTTTTT........TTTTTT......TTTT..........................TTTTTTTTTTTTTTTTTTTT
TT..TTTTTTTT....TTTTTTTTTTTTTTTTTT........TTTTTT......TTTT..........................TTTTTTTTTTTTTTTTTTTT
TT..TTTTTTTT......TTTTTTTTTTTTTTTTTT....TTTTTTTT..............TT............TTTTTTTTTTTTTTTTTTTTTTTTTTTT
TT..TTTTTTTT......TTTTTTTTTTTTTTTTTT....TTTTTTTT..............TT............TTTTTTTTTTTTTTTTTTTTTTTTTTTT
TT....TTTTTTTT......TTTTTTTTTTTTTTTT........TTTT....................TTTTTTTTTTTTTTTT..............TT..TT
TT....TTTTTTTT......TTTTTTTTTTTTTTTT........TTTT....................TTTTTTTTTTTTTTTT..............TT..TT
TT....TTTTTTTT........TTTTTTTTTTTTTTTT........TTTT..............TTTTTTTTTTTTTTTT..........TTTT........TT
TT....TTTTTTTT........TTTTTTTTTTTTTTTT........TTTT..............TTTTTTTTTTTTTTTT..........TTTT........TT
TT....TTTTTTTTTT....TTTTTTTTTT........TTTTTTTTTT........TTTTTTTTTTTTTTTT..............TTTTTTTT........TT
TT....TTTTTTTTTT....TTTTTTTTTT........TTTTTTTTTT........TTTTTTTTTTTTTTTT..............TTTTTTTT........TT
TTTT..TTTTTTTTTTTTTTTTTTTT......TTTT....TTTTTTTT........TTTTTTTTTTTT................TTTTTT............TT
TTTT..TTTTTTTTTTTTTTTTTTTT......TTTT....TTTTTTTT........TTTTTTTTTTTT................TTTTTT............TT
TTTT..TTTTTTTTTTTTTTTTTTTT....TTTTTT..............................................TTTTTTTT............TT
TTTT..TTTTTTTTTTTTTTTTTTTT....TTTTTT..............................................TTTTTTTT............TT
TTTT......TTTTTTTTTTTTTTTTTT..TTTTTTTT..TTTTTT................................TTTTTTTTTTTT............TT
TTTT......TTTTTTTTTTTTTTTTTT..TTTTTTTT..TTTTTT................................TTTTTTTTTTTT............TT
TTTTTT......TTTTTTTTTTTTTTTTTTTTTTTTTTTTTTTTTTTTTT..................TTTTTTTTTTTTTTTTTTTTTTTTTTTTTTTTTTTT
TTTTTT......TTTTTTTTTTTTTTTTTTTTTTTTTTTTTTTTTTTTTT..................TTTTTTTTTTTTTTTTTTTTTTTTTTTTTTTTTTTT
TTTTTTTTTTTTTTTTTTTTTTTTTTTTTTTTTTTTTTTTTTTTTTTTTTTTTTTTTTTTTTTTTTTTTTTTTTTTTTTTTTTTTTTTTTTTTTTTTTTTTTTT
TTTTTTTTTTTTTTTTTTTTTTTTTTTTTTTTTTTTTTTTTTTTTTTTTTTTTTTTTTTTTTTTTTTTTTTTTTTTTTTTTTTTTTTTTTTTTTTTTTTTTTTT
