type octile
height 25
width 25
map
@.@.................@....
.....@...........@.......
..........@.....@..@.....
........@.@........@..@.@
.@.@..............@......
...@@.......@..@.........
...@.....@...@....@.@....
......@..@..@............
.@.......@.....@.@.......
.........@@....@....@@...
.............@....@....@.
.........@.......@.....@.
@................@......@
.@.....@.....@....@.....@
.............@@..@.......
........@@@..............
..............@..........
......@..........@..@....
....@.....@@..@...@@.....
.....@.@@..@....@........
.........@.@.@@.@@....@@.
.@.......@....@....@.....
..@.....@...@..........@.
............@....@...@...
.......@...@.............
