type octile
height 16
width 12
map
@..@@.@@@@.@
@...@...@...
@.......@...
@...@.......
@.@@@@@@@@.@
....@.......
@...@...@...
@...@...@...
@..@@@@@@@.@
@...@...@...
....@.......
@...@...@...
@..@@@@@@.@@
@...@...@...
@...@.......
........@...