type octile
height 5
width 6
map
......
TT.TTT
T.....
..T.T.
.T.T..
......
