type octile
height 9
width 11
map
..TTTT.....
T..TTT.TTTT
.T..TT.T...
..T..T.T...
...T...T...
....T.T....
...........
...........
...........
