type octile
height 5
width 5
map
.T...
.TTT.
.....
TTT.T
.....
