{
    "agents": [[0, 0], [10, 10]],
    "map": [
        [0, 1, 0, 0, 0, 1, 1, 0, 0, 0, 0],
        [0, 0, 0, 1, 0, 1, 0, 0, 1, 0, 0],
        [1, 1, 1, 1, 0, 1, 0, 1, 1, 1, 1],
        [0, 0, 1, 0, 0, 0, 0, 0, 0, 0, 0],
        [0, 1, 1, 0, 1, 1, 1, 1, 1, 1, 0],
        [0, 0, 1, 0, 1, 0, 0, 0, 1, 0, 0],
        [1, 0, 1, 0, 1, 0, 1, 0, 1, 0, 1],
        [1, 0, 0, 0, 1, 1, 1, 0, 1, 0, 0],
        [0, 0, 1, 0, 0, 0, 0, 0, 1, 1, 0],
        [0, 1, 1, 1, 1, 0, 1, 0, 0, 1, 0],
        [0, 0, 0, 0, 0, 0, 1, 1, 0, 0, 0]
    ],
    "movement": "FOUR_WAY_MOVEMENT",
    "los": "BRES_LOS"
}